11111111111111111111
10000000000000000001
100P00000000000C0001
10011001100111111001
10011001100111111001
1C011C01100000C11001
100111111001111110C1
10011111100111111001
1000000110011E000001
10000001100111111001
10000C01100111111001
10000000000000000001
10000000000000C00001
11111111111111111111
