1111111111111111111111111111111111111111111111111111111111111111111111111111111111111111111111111111111111111111
1C000000000001100000000000C00C000000000001100000000000C11C000000000001100000000000C00C000000000001100000000000C1
1011110111110110111110111100001111011111011011111011110110111101111101101111101111000011110111110110111110111101
101111C11111011011111C111100001111C11111011011111C111101101111C11111011011111C111100001111C11111011011111C111101
1011110111110110111110111101101111011111011011111011110110111101111101101111101111011011110111110110111110111101
1000000000000000000000000001100000000000000000000000000000000000000000000000000000011000000000000000000000000001
1011110110111111110110111100001111011011111111011011110110111101101111111101101111000011110110111111110110111101
1011110110111111110110111100001111011011111111011011110110111100001111111101101111000011110110111111110110111101
1000000110000110000110000001100000011000011000011000000110000001100001100001100000011000000110000110000110000001
1000000110000110000110000001100000011000011000011000000000000001100001100001100000011000000110000110000110000001
1011110110000000000110111101101111011000000000011011110110111101100000000001101111011011110110000000000110111101
1011110110111001110110111100001111011011100111011011110110111101101110011101101111000011110110111001110110111101
1000000110100000010110000001100000011010000001011000000110000001101000000101100000011000000110100000010110000001
10000001101E0000P101100000011000000110100000C1011000000110000001101C00000101100000011000000110100000C10110000001
1011110110111111110110111100001111011011111111011011110110111101101111111101101111000011110110111111110110111101
1011110110000000000110111101101111011000000000011011110110111101100000000001101111011011110110000000000110111101
1000000110000110000110000001100000011000011000011000000110000001100001100001100000011000000110000110000110000001
1000000110000110000110000001100000011000011000011000000110000000000001100001100000011000000110000110000110000001
1011110110111111110110111101101111011011111111011011110110111101101111111101101111011011110110111111110110111101
1011110110111111110110111100001111011011111111011011110110111101101111111101101111000011110110111111110110111101
1000000000000000000000000001100000000000000000000000000000000000000000000000000000011000000000000000000000000001
1011110111110110111110111101101111011111011011111011110110111101111101101111101111011011110111110110111110111101
101111C11111011011111C111100001111C11111011011111C111101101111C11111011011111C111100001111C11111011011111C111101
1011110111110110111110111101101111011111011011111011110110111101111101101111101111011011110111110110111110111101
1C000000000001100000000000C11C000000000001100000000000C11C000000000001100000000000C11C000000000001100000000000C1
101111C11111011011111C111100001111C11111011011111C111101101111C11111011011111C111100001111C11111011011111C111101
101111C11111011011111C111100001111C11111011011111C111101101111C11111011011111C111100001111C11111011011111C111101
1C000000000001100000000000C00C000000000001100000000000C11C000000000001100000000000C00C000000000001100000000000C1
1C000000000001100000000000C00C000000000001100000000000C11C000000000001100000000000C00C000000000001100000000000C1
1C000000000001100000000000C00C000000000001100000000000C11C000000000001100000000000C00C000000000001100000000000C1
1C000000000001100000000000C00C000000000001100000000000C11C000000000001100000000000C00C000000000001100000000000C1
101111C11111011011111C111100001111C11111011011111C111101101111C11111011011111C111100001111C11111011011111C111101
101111C11111011011111C111100001111C11111011011111C111101101111C11111011011111C111100001111C11111011011111C111101
101111C11111011011111C111100001111C11111011011111C111101101111C11111011011111C111100001111C11111011011111C111101
1C000000000001100000000000C00C000000000001100000000000C11C000000000001100000000000C00C000000000001100000000000C1
1C000000000001100000000000C00C000000000001100000000000C11C000000000001100000000000C00C000000000001100000000000C1
1C000000000001100000000000C00C000000000001100000000000C11C000000000001100000000000C00C000000000001100000000000C1
1C000000000001100000000000C00C000000000001100000000000C11C000000000001100000000000C00C000000000001100000000000C1
1111111111111111111111111111111111111111111111111111111111111111111111111111111111111111111111111111111111111111
