111111111111111111111111111111111111111111111111111111111111
1C000000000001100000000000C00C000000000001100000000000C000C1
101111011111011011111011110000111101111101101111101111011101
101111C11111011011111C111100001111C11111011011111C1111001101
101111011111011011111011110110111101111101101111101111011101
100000000000000000000000000110000000000000000000000000000001
101111011011111111011011110000111101101111111101101111011101
101111011011111111011011110000111101101111111101101111011101
100000011000011000011000000110000001100001100001100000000001
100000011000011000011000000110000001100001100001100000011101
101111011000000000011011110110111101100000000001101111011101
101111011011100111011011110000111101101110011101101111011101
100000011010000001011000000110000001101000000101100000010001
10000001101E0000P101100000011000000110100000C101100000000001
101111011011111111011011110000111101101111111101101111011101
101111011000000000011011110110111101100000000001101111011101
100000011000011000011000000110000001100001100001100000010001
100000011000011000011000000110000001100001100001100000000001
101111011011111111011011110110111101101111111101101111011101
101111011011111111011011110000111101101111111101101111011101
100000000000000000000000000110000000000000000000000000000001
101111011111011011111011110110111101111101101111101111011101
101111C11111011011111C111100001111C11111011011111C1111011101
101111011111011011111011110110111101111101101111101111011101
1C000000000001100000000000C11C000000000001100000000000C00001
100000000000000000000000000110000000000000000000000000000001
101111011111011011111011110110111101111101101111101111011101
101111C11111011011111C111100001111C11111011011111C111101C001
101111011111011011111011110110111101111101101111101111011101
1C000000000001100000000000C11C000000000001100000000000C00001
111111111111111111111111111111111111111111111111111111111111
