11111111111
1P000000011
101100C0EC1
101C0001001
11111111111
