11111111111111111111
100000H0000000000001
100P00000000000C0001
10H1100110H111111001
10011001100111111001
1C011C01100000C11001
100111111001111110C1
10011111100111111H01
1000000110011E000001
10000001100111111001
10000C01100111111001
10000000000H00000001
1000H000000000C00001
11111111111111111111
