1111111111111111111111111111
1C000000000001100000000000C1
1011110111110110111110111101
101111C11111H11011111C111101
1011110111110110111110111101
100000000000000000000H000001
1011110110111111110110111101
1011110110111111110110111101
1000H00110000110000110000H01
1000000110000110000110000001
1011110110000000000110111101
10111101101110H1110110111101
1000000110100000010110000001
10000001101E0000P1011000H001
1011110110111111110110111101
1011110110000000000110111101
100000011000011000011000H001
10000H0110000110H00110000001
1011110110111111110110111101
1011110110111111110110111101
1000000000000000000000000001
1011110111110110111110111101
101111C11111011011111C111101
1011110111110110111110111101
1C0000000000011000H0000000C1
1111111111111111111111111111
