1111111111111111111111
100000H011100000001C11
100C000011100H0100H001
1000010000000111000001
11111100001101C00001E1
1000C10000C10001100111
1000000H00000H0C1H00P1
1111111111111111111111
