1111111111111
1H010000000C1
10100111110H1
1P0011E000001
1111111111111
