1111111111111111111111111111111111
1E0H0000000H000C00000C000H00000001
1010010100100000101001000000010101
1010010010101010001001H00000010101
1P0000000C00C000H00000000000000HC1
1111111111111111111111111111111111
